!NAME!,Eleven-Square
!NUMBER!,1
!WIDTH!,15
!HEIGHT!,15

!DEFINITIONS!
a,True,images/floor.png,[]
b,False,images/wall.png,[]
D,True,images/floor.png,[zappy/ZappyBasic.json]

!MAP!
b,b,b,b,b,b,b,b,b,b,b,b,b,b,b
b,a,a,a,a,a,a,b,a,a,a,a,a,a,b
b,a,a,a,a,a,a,a,a,a,a,a,a,a,b
b,a,a,a,a,a,a,b,a,a,a,a,a,a,b
b,a,a,a,a,a,a,a,a,a,a,a,a,a,b
b,a,a,a,a,a,a,b,a,a,a,a,a,a,b
b,a,a,a,a,a,a,a,a,a,a,a,a,a,b
b,b,a,b,a,b,a,D,a,b,a,b,a,b,b
b,a,a,a,a,a,a,a,a,a,a,a,a,a,b
b,a,a,a,a,a,a,b,a,a,a,a,a,a,b
b,a,a,a,a,a,a,a,a,a,a,a,a,a,b
b,a,a,a,a,a,a,b,a,a,a,a,a,a,b
b,a,a,a,a,a,a,a,a,a,a,a,a,a,b
b,a,a,a,a,a,a,b,a,a,a,a,a,a,b
b,b,b,b,b,b,b,b,b,b,b,b,b,b,b