!NAME!,Eleven-Square
!NUMBER!,1
!WIDTH!,15
!HEIGHT!,15

!DEFINITIONS!
a,True,images/floor.png,[]
b,False,images/wall.png,[]
e,True,images/floor.png,[adversaries/FastStupidSeismic.json]
t,True,images/floor.png,[tools/ZapGunTool.json]
D,True,images/floor.png,[zappy/ZappyBasic.json]

!MAP!
b,b,b,b,b,b,b,b,b,b,b,b,b,b,b
b,e,t,a,a,a,a,b,a,a,a,a,a,a,b
b,a,a,a,a,a,a,b,a,a,a,a,a,a,b
b,a,a,a,a,t,a,b,a,a,a,a,a,a,b
b,a,b,b,b,b,a,b,a,b,b,b,b,a,b
b,a,a,a,a,a,a,b,a,a,a,a,a,a,b
b,a,a,a,a,a,a,b,a,a,a,a,a,a,b
b,b,a,b,a,b,a,D,a,b,a,b,a,b,b
b,a,a,a,a,a,a,a,a,a,a,a,a,a,b
b,a,a,a,a,a,a,b,a,a,a,a,a,a,b
b,a,a,a,a,a,a,a,a,a,a,a,a,a,b
b,a,a,a,a,a,a,b,a,a,a,a,a,a,b
b,a,a,a,a,a,a,a,a,a,a,a,a,a,b
b,a,a,a,a,a,a,b,a,a,a,a,a,a,b
b,b,b,b,b,b,b,b,b,b,b,b,b,b,b